5'-UMP	SIMPLE_MOLECULE	UMP
GlnA	PROTEIN	GLUTAMINESYN-MONOMER
GlnB	PROTEIN	PROTEIN-PII
GlnB	SIMPLE_MOLECULE	URIDYLYL-PROTEIN-PII
GlnB	SIMPLE_MOLECULE	|Gln-B|
GlnD	PROTEIN	GLND-MONOMER
GlnE	PROTEIN	GLNE-MONOMER
GlnG	PROTEIN	PROTEIN-NRI
GlnK	PROTEIN	PROTEIN-PII2
GlnK	SIMPLE_MOLECULE	PROTEIN-PII2
GlnL	PROTEIN	PROTEIN-NRIIP
L-glutamate	SIMPLE_MOLECULE	GLT
NRI-PWY	PROTEIN
NtrC	PROTEIN	GLNG-CPLX
PII	PROTEIN	PIIPROTEIN-CPLX
YbaI	SIMPLE_MOLECULE	URIDYLYL-PII2
[glutamine synthetase]-O4-(5'-adenylyl)-L-tyrosine	SIMPLE_MOLECULE	|Glutamine-synthetase-adenylyl-Tyr|
[glutamine-synthetase]-L-tyrosine	SIMPLE_MOLECULE	|Glutamine-synthetase-Tyr|
ammonium	SIMPLE_MOLECULE	AMMONIUM
diphosphate	SIMPLE_MOLECULE	PPI
glutamine	SIMPLE_MOLECULE	GLN
phosphate	SIMPLE_MOLECULE	|Pi|
uridine-triphosphate	SIMPLE_MOLECULE	UTP
