 # conformaciones_inactivas.txt
#Â generated: 2016-04-08 13:58:13
# RegulonDB: 9.1, release: 04-07-2016
AcrR	AcrR-Ethidium|AcrR-Proflavin|AcrR-R6G	[IPI|W|Inferred from physical interaction],[BPP|S|Binding of purified proteins]	Strong
AlaS	AlaS	[BPP|S|Binding of purified proteins]	Strong
AllR	AllR-Glyoxylate	[GEA|W|Gene expression analysis],[BPP|S|Binding of purified proteins]	Strong
AllS	AllS	[GEA|W|Gene expression analysis],[BPP|S|Binding of purified proteins]	Strong
AlsR	AlsR-D-allose	[GEA|W|Gene expression analysis],[IPI|W|Inferred from physical interaction]	Weak
AraC	AraC-D-fucose	[IPI|W|Inferred from physical interaction]	Weak
ArcA	ArcA	[IPI|W|Inferred from physical interaction],[BPP|S|Binding of purified proteins]	Strong
ArgP	ArgP-Lysine	[GEA|W|Gene expression analysis],[IPI|W|Inferred from physical interaction],[BPP|S|Binding of purified proteins]	Strong
ArgR	ArgR	[IDA|S|Inferred from direct assay],[GEA|W|Gene expression analysis],[IPI|W|Inferred from physical interaction],[BPP|S|Binding of purified proteins]	Strong
ArsR	ArsR-antimonite|ArsR-arsenite	[GEA|W|Gene expression analysis],[SM|S|Site mutation],[IPI|W|Inferred from physical interaction],[BPP|S|Binding of purified proteins]	Strong
AsnC	AsnC-L-asparagine	[IPI|W|Inferred from physical interaction]	Weak
AtoC	AtoC	[GEA|W|Gene expression analysis],[SM|S|Site mutation],[IPI|W|Inferred from physical interaction],[BPP|S|Binding of purified proteins],[AIFS|W|Automated inference of function from sequence]	Strong
BetI	BetI-choline	[GEA|W|Gene expression analysis],[BPP|S|Binding of purified proteins]	Strong
BirA	BirA	[SM|S|Site mutation],[IPI|W|Inferred from physical interaction]	Strong
CRP	CRP	[IPI|W|Inferred from physical interaction]	Weak
Cbl	Cbl-Thiosulphate|Cbl-adenosine 5' phosphosulphate	[GEA|W|Gene expression analysis],[SM|S|Site mutation],[IPI|W|Inferred from physical interaction],[BPP|S|Binding of purified proteins]	Strong
Cbl	Cbl-Thiosulphate|Cbl-adenosine 5' phosphosulphate	[IDA|S|Inferred from direct assay],[GEA|W|Gene expression analysis],[SM|S|Site mutation],[IPI|W|Inferred from physical interaction],[BPP|S|Binding of purified proteins]	Strong
CpxR	CpxR	[IPI|W|Inferred from physical interaction],[BPP|S|Binding of purified proteins]	Strong
Cra	Cra-Fructose-1,6-diphosphate|Cra-Fructose-1-phosphate	[GEA|W|Gene expression analysis],[BPP|S|Binding of purified proteins]	Strong
CreB	CreB	[IPI|W|Inferred from physical interaction],[BPP|S|Binding of purified proteins]	Strong
CueR	CueR	[IDA|S|Inferred from direct assay],[IPI|W|Inferred from physical interaction]	Strong
CusR	CusR	[IDA|S|Inferred from direct assay],[GEA|W|Gene expression analysis],[IPI|W|Inferred from physical interaction],[BPP|S|Binding of purified proteins]	Strong
CysB	CysB-Sulphide|CysB-Thiosulfate	[IDA|S|Inferred from direct assay],[BPP|S|Binding of purified proteins]	Strong
CysB	CysB-Sulphide|CysB-Thiosulfate	[IDA|S|Inferred from direct assay],[GEA|W|Gene expression analysis]	Strong
CytR	CytR-Cytidine	[BPP|S|Binding of purified proteins]	Strong
DcuR	DcuR	[GEA|W|Gene expression analysis],[IPI|W|Inferred from physical interaction],[BPP|S|Binding of purified proteins]	Strong
DeoR	DeoR-Deoxyribose-5-phosphate	[IPI|W|Inferred from physical interaction],[BPP|S|Binding of purified proteins]	Strong
DhaR	DhaR-DhaK	[IPI|W|Inferred from physical interaction],[BPP|S|Binding of purified proteins]	Strong
DnaA	DnaA	[IPI|W|Inferred from physical interaction],[BPP|S|Binding of purified proteins]	Strong
DpiA	DpiA	[SM|S|Site mutation],[IEP|W|Inferred from expression pattern]	Strong
EvgA	EvgA	[SM|S|Site mutation],[BPP|S|Binding of purified proteins],[AIFS|W|Automated inference of function from sequence]	Strong
FNR	FNR-[2Fe-2S]<sup>2+</sup> oxidized	[IDA|S|Inferred from direct assay],[IPI|W|Inferred from physical interaction]	Strong
FadR	FadR-acyl-CoA	[IPI|W|Inferred from physical interaction],[BPP|S|Binding of purified proteins]	Strong
FhlA	FhlA	[IDA|S|Inferred from direct assay],[GEA|W|Gene expression analysis],[SM|S|Site mutation],[BPP|S|Binding of purified proteins]	Strong
FucR	FucR	[GEA|W|Gene expression analysis],[IPI|W|Inferred from physical interaction],[IMP|W|Inferred from mutant phenotype]	Weak
Fur	Fur	[IDA|S|Inferred from direct assay],[GEA|W|Gene expression analysis],[IPI|W|Inferred from physical interaction]	Strong
GalR	GalR-galactose	[IDA|S|Inferred from direct assay],[GEA|W|Gene expression analysis],[IPI|W|Inferred from physical interaction],[BPP|S|Binding of purified proteins]	Strong
GalS	GalS-galactose	[IDA|S|Inferred from direct assay],[GEA|W|Gene expression analysis],[IPI|W|Inferred from physical interaction],[BPP|S|Binding of purified proteins]	Strong
GcvA	GcvA-Glycine|GcvA-Purine	[GEA|W|Gene expression analysis],[SM|S|Site mutation],[BPP|S|Binding of purified proteins]	Strong
GlcC	GlcC	[GEA|W|Gene expression analysis],[BPP|S|Binding of purified proteins]	Strong
GlpR	GlpR-glycerol-3-phosphate	[IPI|W|Inferred from physical interaction],[BPP|S|Binding of purified proteins]	Strong
GlrR	GlrR	[IDA|S|Inferred from direct assay],[GEA|W|Gene expression analysis],[BPP|S|Binding of purified proteins],[IEP|W|Inferred from expression pattern]	Strong
GntR	GntR-gluconate	[GEA|W|Gene expression analysis],[IEP|W|Inferred from expression pattern]	Weak
GutR	GutR-glucitol	[GEA|W|Gene expression analysis]	Weak
IclR	IclR-glyoxylate	[IDA|S|Inferred from direct assay],[GEA|W|Gene expression analysis],[IPI|W|Inferred from physical interaction],[BPP|S|Binding of purified proteins]	Strong
IdnR	IdnR	[GEA|W|Gene expression analysis],[IMP|W|Inferred from mutant phenotype]	Weak
KdpE	KdpE	[IPI|W|Inferred from physical interaction],[BPP|S|Binding of purified proteins],[IEP|W|Inferred from expression pattern]	Strong
LacI	LacI-allolactose	[IPI|W|Inferred from physical interaction]	Weak
LsrR	LsrR-4,5-dihydroxy-2,3-pentanedione|LsrR-4,5-dihydroxy-2,3-pentanedione-P	[IMP|W|Inferred from mutant phenotype],[IEP|W|Inferred from expression pattern]	Weak
LsrR	LsrR-4,5-dihydroxy-2,3-pentanedione|LsrR-4,5-dihydroxy-2,3-pentanedione-P	[IPI|W|Inferred from physical interaction]	Weak
MalT	MalT|MalT-Aes|MalT-MalK|MalT-MalY	[GEA|W|Gene expression analysis],[IPI|W|Inferred from physical interaction],[BPP|S|Binding of purified proteins],[IEP|W|Inferred from expression pattern]	Strong
MalT	MalT|MalT-Aes|MalT-MalK|MalT-MalY	[GEA|W|Gene expression analysis],[SM|S|Site mutation],[IPI|W|Inferred from physical interaction],[BPP|S|Binding of purified proteins],[IEP|W|Inferred from expression pattern]	Strong
MalT	MalT|MalT-Aes|MalT-MalK|MalT-MalY	[IDA|S|Inferred from direct assay],[SM|S|Site mutation],[IPI|W|Inferred from physical interaction],[IMP|W|Inferred from mutant phenotype],[BPP|S|Binding of purified proteins]	Strong
MalT	MalT|MalT-Aes|MalT-MalK|MalT-MalY	[IPI|W|Inferred from physical interaction]	Weak
MarR	MarR-2,4-dinitrophenol|MarR-Benzoate|MarR-Menadione|MarR-Paraquat|MarR-Phenazine methosulfate|MarR-Plumbagin|MarR-Sodium salicylate|MarR-salicylate	[GEA|W|Gene expression analysis],[BPP|S|Binding of purified proteins]	Strong
MarR	MarR-2,4-dinitrophenol|MarR-Benzoate|MarR-Menadione|MarR-Paraquat|MarR-Phenazine methosulfate|MarR-Plumbagin|MarR-Sodium salicylate|MarR-salicylate	[GEA|W|Gene expression analysis],[IPI|W|Inferred from physical interaction],[BPP|S|Binding of purified proteins]	Strong
MarR	MarR-2,4-dinitrophenol|MarR-Benzoate|MarR-Menadione|MarR-Paraquat|MarR-Phenazine methosulfate|MarR-Plumbagin|MarR-Sodium salicylate|MarR-salicylate	[IPI|W|Inferred from physical interaction],[BPP|S|Binding of purified proteins]	Strong
MetJ	MetJ	[IPI|W|Inferred from physical interaction],[BPP|S|Binding of purified proteins]	Strong
MetR	MetR	[GEA|W|Gene expression analysis],[SM|S|Site mutation],[BPP|S|Binding of purified proteins]	Strong
MhpR	MhpR	[GEA|W|Gene expression analysis],[IPI|W|Inferred from physical interaction],[BPP|S|Binding of purified proteins]	Strong
Mlc	Mlc-EIIGlC	[IDA|S|Inferred from direct assay],[IPI|W|Inferred from physical interaction],[BPP|S|Binding of purified proteins],[IEP|W|Inferred from expression pattern]	Strong
MntR	MntR	[GEA|W|Gene expression analysis],[IPI|W|Inferred from physical interaction],[BPP|S|Binding of purified proteins],[IEP|W|Inferred from expression pattern]	Strong
ModE	ModE	[IPI|W|Inferred from physical interaction],[BPP|S|Binding of purified proteins]	Strong
MprA	MprA-2,4-dinitrophenol|MprA-Carbonyl cyanide m-chlorophenylhydrazone (CCCP)|MprA-Carbonyl cyanide p-(trifluoro-methoxy)phenylhydrazone	[GEA|W|Gene expression analysis],[BPP|S|Binding of purified proteins]	Strong
MurR	MurR-MurNac-6-P	[GEA|W|Gene expression analysis],[IPI|W|Inferred from physical interaction],[BPP|S|Binding of purified proteins]	Strong
NagC	NagC-N-acetyl-D-glucosamine-6-phosphate	[IMP|W|Inferred from mutant phenotype],[BPP|S|Binding of purified proteins]	Strong
NanR	NanR-N-acetylneuraminate	[BPP|S|Binding of purified proteins]	Strong
NarL	NarL	[IPI|W|Inferred from physical interaction],[BPP|S|Binding of purified proteins]	Strong
NarP	NarP	[IPI|W|Inferred from physical interaction],[BPP|S|Binding of purified proteins]	Strong
NhaR	NhaR	[GEA|W|Gene expression analysis],[IPI|W|Inferred from physical interaction],[BPP|S|Binding of purified proteins]	Strong
NikR	NikR	[IPI|W|Inferred from physical interaction],[BPP|S|Binding of purified proteins]	Strong
NsrR	NsrR-[2Fe-2S]<sup>2+</sup> oxidized	[IPI|W|Inferred from physical interaction],[BPP|S|Binding of purified proteins]	Strong
NtrC	NtrC	[IDA|S|Inferred from direct assay],[GEA|W|Gene expression analysis],[IPI|W|Inferred from physical interaction],[BPP|S|Binding of purified proteins]	Strong
OmpR	OmpR	[GEA|W|Gene expression analysis],[IPI|W|Inferred from physical interaction],[BPP|S|Binding of purified proteins]	Strong
PdhR	PdhR-pyruvate	[IDA|S|Inferred from direct assay],[BPP|S|Binding of purified proteins]	Strong
PhoB	PhoB	[IPI|W|Inferred from physical interaction],[BPP|S|Binding of purified proteins]	Strong
PhoP	PhoP	[IPI|W|Inferred from physical interaction],[BPP|S|Binding of purified proteins]	Strong
PurR	PurR	[GEA|W|Gene expression analysis],[IPI|W|Inferred from physical interaction],[BPP|S|Binding of purified proteins]	Strong
QseB	QseB	[IDA|S|Inferred from direct assay],[GEA|W|Gene expression analysis],[IPI|W|Inferred from physical interaction],[IEP|W|Inferred from expression pattern]	Strong
RbsR	RbsR-D-ribose	[IDA|S|Inferred from direct assay],[IPI|W|Inferred from physical interaction],[BPP|S|Binding of purified proteins]	Strong
RcnR	RcnR-Co<sup>2+</sup>|RcnR-Ni<sup>2+</sup>	[GEA|W|Gene expression analysis],[IPI|W|Inferred from physical interaction],[BPP|S|Binding of purified proteins]	Strong
RstA	RstA	[IPI|W|Inferred from physical interaction],[BPP|S|Binding of purified proteins]	Strong
RutR	RutR-Thymine|RutR-uracil	[IDA|S|Inferred from direct assay],[BPP|S|Binding of purified proteins],[IEP|W|Inferred from expression pattern]	Strong
SoxR	SoxR-[2Fe-2S]<sup>2+</sup> reduced	[IDA|S|Inferred from direct assay],[GEA|W|Gene expression analysis],[SM|S|Site mutation],[IPI|W|Inferred from physical interaction],[BPP|S|Binding of purified proteins],[IEP|W|Inferred from expression pattern]	Strong
TorR	TorR-TorI	[IPI|W|Inferred from physical interaction],[BPP|S|Binding of purified proteins]	Strong
TreR	TreR-Trehalose|TreR-trehalose-6-phosphate	[IPI|W|Inferred from physical interaction],[BPP|S|Binding of purified proteins]	Strong
TrpR	TrpR	[IPI|W|Inferred from physical interaction],[BPP|S|Binding of purified proteins],[AIFS|W|Automated inference of function from sequence]	Strong
TyrR	TyrR	[GEA|W|Gene expression analysis],[SM|S|Site mutation],[IPI|W|Inferred from physical interaction],[BPP|S|Binding of purified proteins]	Strong
UhpA	UhpA	[IPI|W|Inferred from physical interaction],[BPP|S|Binding of purified proteins]	Strong
UxuR	UxuR-fructuronate	[GEA|W|Gene expression analysis],[IMP|W|Inferred from mutant phenotype]	Weak
XylR	XylR	[GEA|W|Gene expression analysis],[BPP|S|Binding of purified proteins]	Strong
YqjI	YqjI-Fe<sup>2+</sup>|YqjI-Ni<sup>2+</sup>	[IDA|S|Inferred from direct assay],[GEA|W|Gene expression analysis],[IPI|W|Inferred from physical interaction]	Strong
ZntR	ZntR	[IPI|W|Inferred from physical interaction]	Weak
ZraR	ZraR	[IPI|W|Inferred from physical interaction]	Weak
Zur	Zur	[IPI|W|Inferred from physical interaction],[BPP|S|Binding of purified proteins]	Strong
