Cmk	PROTEIN	CMPKI-MONOMER
Ndk	PROTEIN	NUCLEOSIDE-DIP-KIN-MONOMER
PWY-7197	PROTEIN
Tmk	PROTEIN	DTMPKI-MONOMER
cytidine-diphosphate	SIMPLE_MOLECULE	CDP
cytidine-triphosphate	SIMPLE_MOLECULE	CTP
cytidylate	SIMPLE_MOLECULE	CMP
dADP	SIMPLE_MOLECULE	DADP
dATP	SIMPLE_MOLECULE	DATP
dCDP	SIMPLE_MOLECULE	DCDP
dCMP	SIMPLE_MOLECULE	DCMP
dCTP	SIMPLE_MOLECULE	DCTP
dGDP	SIMPLE_MOLECULE	DGDP
dGTP	SIMPLE_MOLECULE	DGTP
dTDP	SIMPLE_MOLECULE	TDP
dTMP	SIMPLE_MOLECULE	TMP
dTTP	SIMPLE_MOLECULE	TTP
dUDP	SIMPLE_MOLECULE	DUDP
dUTP	SIMPLE_MOLECULE	DUTP
guanosine-diphosphate	SIMPLE_MOLECULE	GDP
guanosine-triphosphate	SIMPLE_MOLECULE	GTP
nucleoside diphosphate	SIMPLE_MOLECULE	|Nucleoside-Diphosphates|
nucleoside triphosphate	SIMPLE_MOLECULE	|Nucleoside-Triphosphates|
uridine-diphosphate	SIMPLE_MOLECULE	UDP
uridine-triphosphate	SIMPLE_MOLECULE	UTP
