5-amino-6-(5'-phosphoribosylamino)uracil	SIMPLE_MOLECULE	CPD-602
5-amino-6-(5-phosphoribitylamino)uracil	SIMPLE_MOLECULE	CPD-1086
5-amino-6-(D-ribitylamino)uracil	SIMPLE_MOLECULE	AMINO-RIBOSYLAMINO-1H-3H-PYR-DIONE
6,7-dimethyl-8-(1-D-ribityl)lumazine	SIMPLE_MOLECULE	DIMETHYL-D-RIBITYL-LUMAZINE
DARP	SIMPLE_MOLECULE	DIAMINO-OH-PHOSPHORIBOSYLAMINO-PYR
RIBOSYN2-PWY	PROTEIN
RibA	PROTEIN	GTP-CYCLOHYDRO-II-MONOMER
RibB	PROTEIN	DIOHBUTANONEPSYN-MONOMER
RibC	PROTEIN	RIBOFLAVIN-SYN-MONOMER
RibD	PROTEIN	RIBOFLAVINSYNDEAM-MONOMER
RibE	PROTEIN	LUMAZINESYN-MONOMER
RibF	PROTEIN	RIBF-MONOMER
YbjI	PROTEIN	G6442-MONOMER
YigB	PROTEIN	EG11202-MONOMER
ammonium	SIMPLE_MOLECULE	AMMONIUM
diphosphate	SIMPLE_MOLECULE	PPI
flavin mononucleotide	SIMPLE_MOLECULE	FMN
flavitan	SIMPLE_MOLECULE	FAD
formate	SIMPLE_MOLECULE	FORMATE
guanosine-triphosphate	SIMPLE_MOLECULE	GTP
phosphate	SIMPLE_MOLECULE	|Pi|
riboflavin	SIMPLE_MOLECULE	RIBOFLAVIN
ribulose-5P	SIMPLE_MOLECULE	RIBULOSE-5P
tetrolose phosphate	SIMPLE_MOLECULE	DIHYDROXY-BUTANONE-P
