3-dehydroshikimate	SIMPLE_MOLECULE	3-DEHYDRO-SHIKIMATE
3-enolpyruvyl-shikimate-5-P	SIMPLE_MOLECULE	3-ENOLPYRUVYL-SHIKIMATE-5P
5-de-H-quinate	SIMPLE_MOLECULE	DEHYDROQUINATE
ARO-PWY	PROTEIN
AroA	PROTEIN	AROA-MONOMER
AroB	PROTEIN	AROB-MONOMER
AroC	PROTEIN	AROC-MONOMER
AroD	PROTEIN	AROD-MONOMER
AroE	PROTEIN	AROE-MONOMER
AroF	PROTEIN	AROF-MONOMER
AroG	PROTEIN	AROG-MONOMER
AroH	PROTEIN	AROH-MONOMER
AroK	PROTEIN	AROK-MONOMER
AroL	PROTEIN	AROL-MONOMER
DAHP	SIMPLE_MOLECULE	3-DEOXY-D-ARABINO-HEPTULOSONATE-7-P
P-enol-pyruvate	SIMPLE_MOLECULE	PHOSPHO-ENOL-PYRUVATE
YdiB	PROTEIN	EG11234-MONOMER
chorismate	SIMPLE_MOLECULE	CHORISMATE
erythrose-4P	SIMPLE_MOLECULE	ERYTHROSE-4P
phosphate	SIMPLE_MOLECULE	|Pi|
quinate	SIMPLE_MOLECULE	QUINATE
shikimate	SIMPLE_MOLECULE	SHIKIMATE
shikimate-5-P	SIMPLE_MOLECULE	SHIKIMATE-5P
