10-formyl-THF mono-L-glutamate	SIMPLE_MOLECULE	FORMYL-THF-GLU-N
Ara4N-modified (KDO)2-Lipid A	SIMPLE_MOLECULE	L-ARA4N-MODIFIED-KDO2-LIPID-A
ArnA	PROTEIN	G7168-MONOMER
ArnB	PROTEIN	G7166-MONOMER
ArnC	PROTEIN	G7167-MONOMER
ArnT	PROTEIN	G7170-MONOMER
CO2	SIMPLE_MOLECULE	CARBON-DIOXIDE
L-glutamate	SIMPLE_MOLECULE	GLT
PWY0-1338	PROTEIN
Re endotoxin	SIMPLE_MOLECULE	KDO2-LIPID-A
THF polyglutamate	SIMPLE_MOLECULE	THF-GLU-N
UDP-4-amino-4-deoxy-L-arabinose	SIMPLE_MOLECULE	UDP-4-AMINO-4-DEOXY-L-ARABINOSE
UDP-L-Ara4FN	SIMPLE_MOLECULE	UDP-L-ARA4-FORMYL-N
UDP-L-Ara4O	SIMPLE_MOLECULE	5-BETA-L-THREO-PENTAPYRANOSYL-4-ULOSE-
ditrans,octacis-undecaprenyl phosphate-alpha-L-Ara4N	SIMPLE_MOLECULE	CPD0-1189
ditrans,polycis-undecaprenyl phosphate	SIMPLE_MOLECULE	CPD-9646
ketoglutarate	SIMPLE_MOLECULE	2-KETOGLUTARATE
udp-glcua	SIMPLE_MOLECULE	UDP-GLUCURONATE
undecaprenyl phosphate-L-Ara4-Formyl-N	SIMPLE_MOLECULE	CPD0-888
uridine-diphosphate	SIMPLE_MOLECULE	UDP
