AICAR	SIMPLE_MOLECULE	AICAR
HISTSYN-PWY	PROTEIN
HisA	PROTEIN	PRIBFAICARPISOM-MONOMER
HisB	PROTEIN	IMIDPHOSPHADEHYDHISTIDPHOSPHA-MONOMER
HisC	PROTEIN	HISTPHOSTRANS-MONOMER
HisD	PROTEIN	HISTDEHYD-MONOMER
HisF	PROTEIN	CYCLASE-MONOMER
HisG	PROTEIN	ATPPHOSRIBOSTRANS-MONOMER
HisH	PROTEIN	GLUTAMIDOTRANS-MONOMER
HisH-HisF	COMPLEX	GLUTAMIDOTRANS-CPLX
HisI	PROTEIN	HISTCYCLOPRATPPHOS
L-glutamate	SIMPLE_MOLECULE	GLT
PRFAR	SIMPLE_MOLECULE	PHOSPHORIBULOSYL-FORMIMINO-AICAR-P
PRPP	SIMPLE_MOLECULE	PRPP
diphosphate	SIMPLE_MOLECULE	PPI
erythro-imidazole-glycerol-P	SIMPLE_MOLECULE	D-ERYTHRO-IMIDAZOLE-GLYCEROL-P
glutamine	SIMPLE_MOLECULE	GLN
histidinal	SIMPLE_MOLECULE	HISTIDINAL
histidine	SIMPLE_MOLECULE	HIS
histidinol-P	SIMPLE_MOLECULE	L-HISTIDINOL-P
histidol	SIMPLE_MOLECULE	HISTIDINOL
imidazole acetol-P	SIMPLE_MOLECULE	IMIDAZOLE-ACETOL-P
ketoglutarate	SIMPLE_MOLECULE	2-KETOGLUTARATE
phosphate	SIMPLE_MOLECULE	|Pi|
phosphoribosyl-AMP	SIMPLE_MOLECULE	PHOSPHORIBOSYL-AMP
phosphoribosyl-ATP	SIMPLE_MOLECULE	PHOSPHORIBOSYL-ATP
phosphoribosylformiminoAICAR-P	SIMPLE_MOLECULE	PHOSPHORIBOSYL-FORMIMINO-AICAR-P
