CyoA	PROTEIN	CYOA-MONOMER
CyoB	PROTEIN	CYOB-MONOMER
CyoC	PROTEIN	CYOC-MONOMER
CyoD	PROTEIN	CYOD-MONOMER
CyoD-CyoA-CyoB-CyoC	COMPLEX	CYT-O-UBIOX-CPLX
NuoA	PROTEIN	NUOA-MONOMER
NuoA-NuoH-NuoJ-NuoK-NuoL-NuoM-NuoN-NuoI-NuoG-NuoF-NuoE-NuoC-NuoB	COMPLEX	NADH-DHI-CPLX
NuoB	PROTEIN	NUOB-MONOMER
NuoB-NuoC-NuoE-NuoF-NuoG-NuoI	COMPLEX	CPLX0-3361
NuoC	PROTEIN	NUOC-MONOMER
NuoE	PROTEIN	NUOE-MONOMER
NuoF	PROTEIN	NUOF-MONOMER
NuoG	PROTEIN	NUOG-MONOMER
NuoH	PROTEIN	NUOH-MONOMER
NuoI	PROTEIN	NUOI-MONOMER
NuoJ	PROTEIN	NUOJ-MONOMER
NuoK	PROTEIN	NUOK-MONOMER
NuoL	PROTEIN	NUOL-MONOMER
NuoM	PROTEIN	NUOM-MONOMER
NuoN	PROTEIN	NUON-MONOMER
PWY0-1335	PROTEIN
menaquinol	SIMPLE_MOLECULE	|Menaquinols|
oxygen_Ext	SIMPLE_MOLECULE	OXYGEN-MOLECULE_Ext
ubiquinol	SIMPLE_MOLECULE	|Ubiquinols|
ubiquinol_Ext	SIMPLE_MOLECULE	|Ubiquinols|_Ext
ubiquinone	SIMPLE_MOLECULE	|Ubiquinones|
ubiquinone_Ext	SIMPLE_MOLECULE	|Ubiquinones|_Ext
vitamin K2_Ext	SIMPLE_MOLECULE	|Menaquinones|_Ext
